101100011110111111101111101011
100001110010000100100100101000
110100000001110100100101101010
000111011011010110101101001010
110001010010010010101001101000
101111011011010010001110101110
101000000000011011100000100011
111001101101101000110110101001
110101010110110001011110100101
110101110101000011000100110101
110100001101011110001100100111
100100111001110000101011100010
110101100100000011100000101100
000101010111110110110111101001
110101000100010000010001001001
100001110111011011010111011001
001110011001000001110010010011
111010001101101100001110111110
100010000100111001001000000011
111001010111001101111010110001
101001010001010110000110010111
101011010101010011011100010100
101110110001010001110110110101
100000101111010000000010100111
101011100010011010111010110001
111010110110010011101100010101
110010000101111100000111010001
101011000001000001010001000101
101001110110011011011101111101
101001110111011111011111111101