101100011110111111101111101011
100111110011000100100100101110
110100000001110100100101101010
010111011011010110101101001011
110001010010010010111001101000
101111011111010010001110101110
101000000000011011100000100011
111001111111101000111110111001
000111000000001111000010001101
110101010111110001011110100101
010101110101000011000100110101
110100001101011110001100100111
100100111001110000111011100010
110101100000000011100000101110
010101011111110110110111101001
111101000100010000010001001001
101001110111011111010111011001
001110011001000001110010010011
111010001101101100001111111110
100010000100111001001000000011
111001110111001101111011110001
101001010001010110000110010111
101011011101010011011100010100
101110110001010001110110110101
100000101111010000000010100111
101011100010011110111010110001
111010110110010011101100011101
010010000101111100000111010101
111011011101000001110001000101
101001110111011111011111111101
101001110111011111011111111101